XXXXXXXXXXXXXXXXXXXXX
XPOOZZZZZZZZZZZZZOOOX
XOXZXZXZXZXZXZXZXZXOX
XOZZZZZZZZZZZZZZZZZOX
XZXZXZXZXZXZXZXZXZXZX
XZZZZZZZZZZZZZZZZZZZX
XZXZXZXZXZXZXZXZXZXZX
XZZZZZZZZZUZZZZZZZZZX
XZXZXZXZXZXZXZXZXZXZX
XZZZZZZZZZZZZZZZZZZZX
XZXZXZXZXZXZXZXZXZXZX
XOZZZZZZZZZZZZZZZZZOX
XOXZXZXZXZXZXZXZXZXOX
XOOOZZZZZZZZZZZZZOOLX
XXXXXXXXXXXXXXXXXXXXX
