XXXXXXXXXXXXXXXXXXXXX
XPOOZZZZZZZZZZZZZZOOX
XOZXXXZXZXZXZXZXXXZOX
XOZXXZZZZZZZZZZZXXZZX
XZZXZZZZZZXZZZZZZXZZX
XZZZZZZZZZXZZZZZZZZZX
XZZXXZZZZZXZZZZZXXZZX
XZZZZZZZXXXXXZZZZZZZX
XZZXXZZZZZXZZZZZXXZZX
XZZZZZZZZZXZZZUZZZZZX
XZZXZZZZZZXZZZZZZXZZX
XZZXXZZZZZZZZZZZXXZOX
XOZXXXZXZXZXZXZXXXZOX
XOOZZZZZZZZZZZZZZOOLX
XXXXXXXXXXXXXXXXXXXXX