XXXXXXXXXXXXXXXXXXXXX
XPOZZZZZXXXZZZZXXXXXX
XOOOXXZZZZZXXXXXXZZZX
XZZZZXXXXZZZZXXZZZXXX
XXXXZZZZXXXXZZZZXXXXX
XZZZZXXXXZZZZXUZZZZZX
XXXXZZZZXXXXZZZZXXXXX
XXZZZZXXXXZZZZXXXXXXX
XZZZZZZZZZZZZZZZZZZZX
XXXXZZZZZZZZZZZZZXXXX
XZZZZZZZXXXXXXXZZZXXX
XXXXZZZZXXXXZZZZZXXXX
XZZZZXXXXZZZZZXZZOOOX
XZZXXXXZZZZZXXZZZZOLX
XXXXXXXXXXXXXXXXXXXXX