XXXXXXXXXXXXXXXXXXXXX
XPOOZZZZZZZZZZZZZZOOX
XOZXXXZXZXZXZXZXXXZOX
XOZXXZZZZZZZZZZZXXZZX
XZZXZZZZZZXZZZZZZXZZX
XZZZZZZZZZXZZZZZZZZZX
XZZXXZZZZZXZZZZZXXZZX
XZZZZZZZXXXXXZZZZZZZX
XZZXXZZZZZXZZZZZXXZZX
XZZZZZZZZZXZZZZZZZZZX
XZZXZZZZZZXZZZZZZXZZX
XZZXXZZZZZZZZZZZXXZZX
XOZXXXZXZXZXZXZXXXZZX
XOOZZZZZZZZZZZZZZOOLX
XXXXXXXXXXXXXXXXXXXXX