XXXXXXXXXXXXXXXXXXXXX
XP0ZZZZZXXXZZZZXXXXXX
X000XXZZZZZXXXXXXZZZX
XZZZZXXXXZZZZXXZZZXXX
XXXXZZZZXXXXZZZZXXXXX
XZZZZXXXXZZZZXTZZZZZX
XXXXZZZZXXXXZZZZXXXXX
XXZZZZXXXXZZZZXXXXXXX
XZZZZZZZZZZZZZZZZZZZX
XXXXZZZZZZZZZZZZZXXXX
XZZZZZZZXXXXXXXZZZXXX
XXXXZZZZXXXXZZZZZXXXX
XZZZZXXXXZZZZZXXX00ZX
XZZXXXXZZZZZXXZZZZOLX
XXXXXXXXXXXXXXXXXXXXX