XXXXXXXXXXXXXXXXXXXXX
XPOZZZOZZOZZZOZZOZZOX
XOXZXOXZXOXZXOXZXOXZX
XZZZOZZZOZZZOZZZOZZZX
XOXZXOXZXOXZXOXZXOXZX
XZZZOZZZOZZZOZZZOZZZX
XOXZXOXZXTXZXOXZXOXZX
XZZZOZZZOZZZOZZZOZZZX
XOXZXOXZXOXZXOXZXOXZX
XZZZOZZZOZZZOZZZOZZZX
XOXZXOXZXOXZXOXZXOXZX
XZZZOZZZOZZZOZZZOZZZX
XOXZXOXZXOXZXOXZXOXOX
XOZZOZZOZZZOZZOZZZOLX
XXXXXXXXXXXXXXXXXXXXX