XXXXXXXXXXXXXXXXXXXXX
XPOOZZZZXZZZZXZZZOOLX
XOXZZZZZZZXXZZZZZZXOX
XZZZZZZZXZZZZXZZZZZZX
XZZZZZZZXZZZZXZZZZZZX
XZZZZZZZXZZZZXZZZZZZX
XZZZZZZZXZZZZXZZZZZZX
XXXXXZZZZZZZZZZZXXXXX
XXXXZZZZZZZZZZZZZXXXX
XZZZZZZZZXXXZZZZZZZZX
XZZZZZZZZXXXZZZZZZZZX
XZZXZZXZZXXXZZXZZXZZX
XXZZXZZXZZXZZXZZXZZXX
XZZZZZZZZZUZZZZZZZZZX
XXXXXXXXXXXXXXXXXXXXX